160 160 157 160 157 160 160 160 160 160 141 160 160 160 160 160 160 127 110 110 110
165 155 156 160 157 160 160 160 160 160 160 141 160 160 160 160 160 127 110 110 110
157 160 165 155 156 160 160 160 160 160 160 160 160 160 160 160 160 127 110 110 110
157 160 157 160 160 160 160 160 160 160 160 160 160 160 160 160 160 127 110 110 110
156 160 157 160 160 141 160 160 160 160 160 160 160 160 160 160 160 127 110 110 110
160 160 157 160 160 160 160 160 160 160 160 160 160 160 160 160 160 127 110 110 110
160 160 157 160 160 160 160 160 160 160 160 160 160 160 160 160 160 127 110 110 110
155 155 156 160 160 160 160 160 160 160 160 160 160 160 160 160 160 127 110 110 110
160 160 160 160 160 160 160 160 160 160 160 160 160 160 160 160 160 127 110 110 110
151 151 151 151 151 151 151 151 151 151 151 151 151 151 151 151 151 151 151 151 151
151 151 151 151 151 151 151 151 151 151 151 151 151 151 151 151 151 151 151 151 151
151 151 151 151 151 151 151 151 151 151 151 151 151 151 151 151 151 151 151 151 151
160 160 160 141 160 160 160 160 160 160 160 160 160 160 160 160 160 127 110 110 110
160 160 160 160 141 160 160 160 160 160 160 160 160 160 160 160 160 127 110 110 110
160 160 160 160 160 160 160 160 160 160 160 160 160 160 160 160 160 127 110 110 110
160 160 160 160 160 160 160 160 160 160 160 160 160 160 160 160 160 127 110 110 110
160 160 160 160 160 160 160 160 160 160 160 160 160 160 160 141 160 127 110 110 110
160 160 160 160 160 160 160 160 160 160 160 160 160 160 160 160 160 127 110 110 110
141 160 160 160 160 160 160 160 160 160 160 160 160 160 160 160 160 127 110 110 110
160 141 160 160 160 160 160 160 160 160 160 160 141 160 160 160 160 127 110 110 110
160 160 160 160 160 160 160 160 160 160 160 160 160 160 160 160 160 127 110 110 110
160 160 160 160 160 160 160 160 160 160 160 160 160 160 160 160 160 127 110 110 110