115 115 115 115 115 115 115 115 115 115 115 115 115 115 115 115
110 110 110 110 110 110 110 110 110 110 110 110 110 110 110 110
110 110 110 110 110 110 110 110 110 110 110 110 110 110 110 110
193 193 193 193 193 193 193 193 193 193 193 193 193 193 193 193
197 197 197 197 197 197 197 197 197 197 197 197 197 197 197 197
197 197 197 197 197 197 197 197 197 197 197 197 197 197 197 197
197 197 197 197 197 197 197 197 197 197 197 197 197 197 197 197
196 196 196 196 196 196 196 196 196 196 196 196 196 196 196 196
110 110 110 110 110 110 110 110 110 124 125 125 126 110 110 110
110 110 124 125 125 126 110 110 110 128 112 112 127 110 110 110
125 126 128 112 112 127 110 110 110 128 112 112 127 110 110 110
112 122 132 112 112 122 125 125 125 132 112 112 122 125 125 125
112 112 112 112 112 112 112 112 112 112 112 112 112 112 112 112
112 112 112 112 112 112 112 112 112 112 112 112 112 112 112 112