10 10 10 10 10 10 22 21 20 14 15 11 20
20 10 10 10 10 10 13 16 17 15 15 12 12
14 14 14 12 12 12 11 11 11 14 15 16 17
12 11 13 14 15 11 14 18 18 18 18 18 18
18 18 18 18 18 18 18 17 17 17 17 17 17 

