13 13 18 22 22 22 22 22 22 22
14 14 20 22 16 13 13 13 13 13
16 16 16 16 17 17 13 13 13 13
16 16 16 17 17 13 13 13 13 13
16 16 16 13 13 13 13 12 15 15
16 16 16 13 13 13 13 18 22 22
17 16 16 17 13 13 13 18 22 22
17 13 13 13 13 13 13 18 22 22
13 13 13 13 13 13 13 18 22 22
13 13 12 14 14 14 14 20 22 22