113 110 110 110 110 110 110 110 128 112 112 112 198 198
118 110 110 110 110 110 110 124 132 112 112 112 112 112
118 110 134 110 110 110 110 128 112 112 112 112 112 112
118 110 110 110 110 110 110 128 112 112 198 112 112 112
119 110 110 110 133 110 110 128 112 112 112 112 112 112
110 110 110 133 133 110 110 129 130 123 112 112 112 112
110 110 133 133 133 110 110 110 110 128 112 112 112 112
110 110 110 133 110 110 110 110 110 128 112 112 112 112
110 110 110 110 110 110 110 110 110 129 130 130 130 130
116 116 116 116 116 116 116 116 116 116 116 116 116 116
111 111 111 111 111 111 111 111 206 205 206 205 111 111
111 111 111 111 111 111 111 111 111 111 111 111 111 111
111 111 111 111 111 111 111 111 111 111 111 111 111 111
111 111 111 111 111 111 111 111 111 111 111 111 111 111