35 13 10 10 10 73 85 49 50 77 10 10 10 10 10 10 10 10 10 10 10 10 10 10 33
11 18 10 10 10 10 10 10 10 10 10 10 10 10 10 10 10 33 33 10 10 10 10 10 33
11 35 16 16 16 16 16 16 16 16 16 16 13 10 10 10 10 33 33 33 10 10 10 33 33
11 11 11 11 11 38 15 15 36 11 106 105 35 16 13 10 33 33 33 33 33 10 33 33 33
11 11 38 15 15 19 10 10 20 15 15 15 15 15 19 10 33 33 33 33 10 10 33 33 33
11 11 18 101 10 10 10 10 10 10 10 10 10 10 10 10 33 33 33 10 10 10 10 10 33
11 11 18 101 10 10 10 10 33 33 33 33 10 10 33 33 33 10 10 10 10 10 10 10 10
11 11 18 10 10 10 10 10 10 33 33 33 34 10 33 33 33 10 10 10 10 10 10 10 10
11 38 19 10 10 10 33 10 10 10 33 33 33 33 33 33 33 10 10 10 10 10 10 10 10
11 18 10 10 10 10 33 33 10 10 10 33 33 10 10 10 10 10 10 14 16 13 10 10 10
11 18 10 10 33 10 33 33 10 10 10 10 10 10 10 10 10 10 14 37 11 18 10 10 10
11 18 10 10 33 104 33 33 33 10 10 10 10 10 10 10 10 10 17 11 11 18 10 10 10
11 18 10 33 33 33 33 33 10 10 10 10 14 16 16 16 13 10 17 11 11 18 10 10 10
11 18 33 33 33 33 33 10 10 10 10 10 17 11 11 11 35 13 17 11 11 18 10 10 10
11 18 33 33 33 33 10 10 10 10 10 14 37 11 11 11 11 35 37 11 11 18 10 10 10
11 18 33 33 33 10 10 10 10 10 10 17 11 11 11 11 11 11 11 11 11 18 10 10 10
11 18 33 34 34 10 10 10 10 10 10 17 11 11 11 11 11 11 11 11 11 18 10 10 10
11 35 16 16 16 16 16 16 16 16 16 37 11 11 11 11 11 11 11 11 38 19 10 10 10
11 11 11 11 11 11 11 11 11 11 11 11 11 11 11 11 11 11 11 11 18 10 10 10 10
11 11 11 11 11 11 11 11 11 11 11 11 11 11 11 106 105 106 105 11 18 10 10 10 74
15 15 15 15 15 15 15 15 15 15 15 15 15 15 15 15 15 15 15 15 19 10 75 75 50
10 10 33 33 33 33 33 104 10 10 10 10 10 10 10 10 34 34 34 34 10 74 48 50 48
10 10 10 33 33 33 104 10 10 10 10 10 10 10 10 10 10 10 34 34 74 48 50 48 50
72 10 10 10 10 10 10 10 10 10 10 10 10 10 10 10 10 10 10 10 79 50 48 50 48
85 75 72 10 10 10 10 10 10 10 10 10 10 10 10 10 10 10 10 10 74 48 50 48 50