3 3 18 22 22 22 22 22 22 22
4 4 20 22 6 13 3 3 3 3
6 6 6 6 7 17 3 3 3 3
6 6 6 7 17 3 3 3 3 3
6 6 6 13 3 3 3 2 5 5
6 6 6 13 3 3 3 18 22 22
7 16 16 17 3 3 3 18 22 22
17 3 3 3 3 3 3 18 22 22
3 3 3 3 3 3 3 18 22 22
3 3 2 4 4 4 4 20 22 22