226 226 226 226 226 226 223 207 207 218 218 218 218 218 218 218 218 218 218 218
226 226 226 226 226 226 223 207 207 217 217 216 217 217 217 217 217 217 217 217
227 227 227 227 227 227 225 207 207 207 232 230 232 235 207 207 207 234 234 234
207 207 207 207 207 229 233 207 207 207 207 207 207 207 207 207 233 234 234 207
207 207 207 207 207 207 207 213 211 211 211 211 211 211 211 211 211 211 211 211
207 207 207 207 207 207 207 214 212 212 212 212 212 212 212 212 212 212 212 212
229 207 207 207 213 211 211 212 212 212 212 212 212 212 212 212 212 212 212 212
207 207 233 234 214 212 212 212 212 212 212 212 212 212 212 212 212 212 212 212
207 207 234 234 214 212 212 212 212 212 212 212 212 212 212 212 212 212 212 212
207 207 207 234 214 212 212 212 212 212 212 212 212 212 212 212 212 212 212 212
207 207 229 207 214 215 215 212 212 212 212 212 212 212 212 212 212 212 212 212
207 207 207 207 234 234 234 214 212 212 212 212 212 212 212 212 212 212 212 212
207 207 207 207 207 234 234 214 212 212 212 212 212 212 212 212 215 215 215 215
228 228 224 207 234 234 234 214 215 215 215 215 215 215 215 209 207 207 207 207
226 226 223 207 207 234 234 219 207 207 207 229 207 207 207 207 234 234 234 234
226 226 223 207 207 207 234 207 207 207 207 207 207 207 207 207 207 234 234 234
226 226 223 229 207 229 207 207 207 207 207 207 207 207 207 207 207 207 234 234
226 226 223 207 207 207 207 207 229 229 207 207 207 207 229 207 234 234 234 234
226 226 223 218 218 218 218 207 207 207 207 207 207 207 207 207 233 234 234 234
226 226 223 217 217 217 217 207 207 207 207 229 207 207 207 207 207 234 234 207
226 226 223 207 207 207 207 207 229 207 207 207 207 207 207 207 229 207 207 207
226 226 223 207 207 207 229 207 207 207 207 207 207 207 207 207 207 207 207 207
226 226 223 207 207 207 207 207 207 207 207 207 207 229 207 207 207 207 207 207
226 226 223 229 207 207 207 218 218 218 218 218 218 218 218 218 218 218 218 218
226 226 223 207 234 207 207 217 217 217 217 217 217 217 217 217 217 217 216 217
226 226 223 234 234 207 207 207 207 207 207 207 207 207 207 232 232 229 230 231
226 226 223 234 234 207 207 207 207 207 207 207 207 207 207 207 207 207 229 235
226 226 223 234 229 207 207 207 207 229 207 207 207 207 207 207 221 228 228 228
226 226 223 234 234 234 234 207 207 207 207 207 207 207 207 207 222 226 226 226
226 226 223 234 234 233 233 207 207 207 207 207 207 207 207 207 222 226 226 226