135 113 110 110 110 173 185 149 150 177 110 110 110 110 110 110 110 110 110 110 110 110 110 110 133
111 118 110 110 110 110 110 110 110 110 110 110 110 110 110 110 110 133 133 110 110 110 110 110 133
111 135 116 116 116 116 116 116 116 116 116 116 113 110 110 110 110 133 133 133 110 110 110 133 133
111 111 111 111 111 138 115 115 136 111 206 205 135 116 113 110 133 133 133 133 133 110 133 133 133
111 111 138 115 115 119 110 110 120 115 115 115 115 115 119 110 133 133 133 133 110 110 133 133 133
111 111 118 201 110 110 110 110 110 110 110 110 110 110 110 110 133 133 133 110 110 110 110 110 133
111 111 118 201 110 110 110 110 133 133 133 133 110 110 133 133 133 110 110 110 110 110 110 110 110
111 111 118 110 110 110 110 110 110 133 133 133 134 110 133 133 133 110 110 110 110 110 110 110 110
111 138 119 110 110 110 133 110 110 110 133 133 133 133 133 133 133 110 110 110 110 110 110 110 110
111 118 110 110 110 110 133 133 110 110 110 133 133 110 110 110 110 110 110 114 116 113 110 110 110
111 118 110 110 133 110 133 133 110 110 110 110 110 110 110 110 110 110 114 137 111 118 110 110 110
111 118 110 110 133 204 133 133 133 110 110 110 110 110 110 110 110 110 117 111 111 118 110 110 110
111 118 110 133 133 133 133 133 110 110 110 110 114 116 116 116 113 110 117 111 111 118 110 110 110
111 118 133 133 133 133 133 110 110 110 110 110 117 111 111 111 135 113 117 111 111 118 110 110 110
111 118 133 133 133 133 110 110 110 110 110 114 137 111 111 111 111 135 137 111 111 118 110 110 110
111 118 133 133 133 110 110 110 110 110 110 117 111 111 111 111 111 111 111 111 111 118 110 110 110
111 118 133 134 134 110 110 110 110 110 110 117 111 111 111 111 111 111 111 111 111 118 110 110 110
111 135 116 116 116 116 116 116 116 116 116 137 111 111 111 111 111 111 111 111 138 119 110 110 110
111 111 111 111 111 111 111 111 111 111 111 111 111 111 111 111 111 111 111 111 118 110 110 110 110
111 111 111 111 111 111 111 111 111 111 111 111 111 111 111 206 205 206 205 111 118 110 110 110 174
115 115 115 115 115 115 115 115 115 115 115 115 115 115 115 115 115 115 115 115 119 110 175 175 150
110 110 133 133 133 133 133 204 110 110 110 110 110 110 110 110 134 134 134 134 110 174 148 150 148
110 110 110 133 133 133 204 110 110 110 110 110 110 110 110 110 110 110 134 134 174 148 150 148 150
172 110 110 110 110 110 110 110 110 110 110 110 110 110 110 110 110 110 110 110 179 150 148 150 148
185 175 172 110 110 110 110 110 110 110 110 110 110 110 110 110 110 110 110 110 174 148 150 148 150