13 10 10 10 10 10 10 10 28 12 12 12 12
18 10 10 10 10 10 10 24 32 12 12 12 12
18 10 10 10 10 10 10 28 12 12 12 12 12
18 10 10 10 10 10 10 28 12 12 12 12 12
19 10 10 10 33 10 10 28 12 12 12 12 12
10 10 10 33 33 10 10 29 30 23 12 12 12
10 10 33 33 33 10 10 10 10 28 12 12 12
10 10 10 33 10 10 10 10 10 28 12 12 12
10 10 10 10 10 10 10 10 10 29 30 30 30
16 16 16 16 16 16 16 16 16 16 16 16 16
11 11 11 11 11 11 11 11 11 11 11 11 11